"filename", "language", "JavaScript", "JavaScript JSX", "CSS", "comment", "blank", "total"
"c:\Users\Tsags\OneDrive\Υπολογιστής\techlines\client\src\App.js", "JavaScript", -115, 0, 0, 0, -3, -118
"c:\Users\Tsags\OneDrive\Υπολογιστής\techlines\client\src\components\AddNewProduct.jsx", "JavaScript JSX", 0, -230, 0, -1, -12, -243
"c:\Users\Tsags\OneDrive\Υπολογιστής\techlines\client\src\components\Allergies.jsx", "JavaScript JSX", 0, -70, 0, 0, -7, -77
"c:\Users\Tsags\OneDrive\Υπολογιστής\techlines\client\src\components\AnalyticsTab.jsx", "JavaScript JSX", 0, -129, 0, -22, -27, -178
"c:\Users\Tsags\OneDrive\Υπολογιστής\techlines\client\src\components\CartItem.jsx", "JavaScript JSX", 0, -54, 0, 0, -3, -57
"c:\Users\Tsags\OneDrive\Υπολογιστής\techlines\client\src\components\CartOrderSummary.jsx", "JavaScript JSX", 0, -43, 0, 0, -4, -47
"c:\Users\Tsags\OneDrive\Υπολογιστής\techlines\client\src\components\CheckoutItem.jsx", "JavaScript JSX", 0, -34, 0, -14, -3, -51
"c:\Users\Tsags\OneDrive\Υπολογιστής\techlines\client\src\components\CheckoutOrderSummary.jsx", "JavaScript JSX", 0, -112, 0, 0, -7, -119
"c:\Users\Tsags\OneDrive\Υπολογιστής\techlines\client\src\components\CompletedOrdersTab.jsx", "JavaScript JSX", 0, -46, 0, 0, -3, -49
"c:\Users\Tsags\OneDrive\Υπολογιστής\techlines\client\src\components\ConfirmRemovalAlert.jsx", "JavaScript JSX", 0, -38, 0, 0, -5, -43
"c:\Users\Tsags\OneDrive\Υπολογιστής\techlines\client\src\components\Footer.jsx", "JavaScript JSX", 0, -48, 0, 0, -2, -50
"c:\Users\Tsags\OneDrive\Υπολογιστής\techlines\client\src\components\Navbar.jsx", "JavaScript JSX", 0, -224, 0, 0, -15, -239
"c:\Users\Tsags\OneDrive\Υπολογιστής\techlines\client\src\components\Notifications.jsx", "JavaScript JSX", 0, -126, 0, 0, -12, -138
"c:\Users\Tsags\OneDrive\Υπολογιστής\techlines\client\src\components\OrderDetails.jsx", "JavaScript JSX", 0, -190, 0, -12, -13, -215
"c:\Users\Tsags\OneDrive\Υπολογιστής\techlines\client\src\components\OrderHistoryTab.jsx", "JavaScript JSX", 0, -62, 0, 0, -5, -67
"c:\Users\Tsags\OneDrive\Υπολογιστής\techlines\client\src\components\OrdersTab.jsx", "JavaScript JSX", 0, -95, 0, 0, -7, -102
"c:\Users\Tsags\OneDrive\Υπολογιστής\techlines\client\src\components\PasswordTextField.jsx", "JavaScript JSX", 0, -25, 0, 0, -2, -27
"c:\Users\Tsags\OneDrive\Υπολογιστής\techlines\client\src\components\PrintButton.jsx", "JavaScript JSX", 0, -7, 0, 0, -3, -10
"c:\Users\Tsags\OneDrive\Υπολογιστής\techlines\client\src\components\ProductCard.jsx", "JavaScript JSX", 0, -107, 0, -6, -7, -120
"c:\Users\Tsags\OneDrive\Υπολογιστής\techlines\client\src\components\ProductTableItem.jsx", "JavaScript JSX", 0, -221, 0, 0, -8, -229
"c:\Users\Tsags\OneDrive\Υπολογιστής\techlines\client\src\components\ProductsTab.jsx", "JavaScript JSX", 0, -115, 0, 0, -6, -121
"c:\Users\Tsags\OneDrive\Υπολογιστής\techlines\client\src\components\ProtectedAdminRoute.jsx", "JavaScript JSX", 0, -7, 0, 0, -3, -10
"c:\Users\Tsags\OneDrive\Υπολογιστής\techlines\client\src\components\ProtectedRoute.jsx", "JavaScript JSX", 0, -7, 0, 0, -3, -10
"c:\Users\Tsags\OneDrive\Υπολογιστής\techlines\client\src\components\QRcodeGenerator.jsx", "JavaScript JSX", 0, -26, 0, 0, -6, -32
"c:\Users\Tsags\OneDrive\Υπολογιστής\techlines\client\src\components\Recommendations.jsx", "JavaScript JSX", 0, -44, 0, -5, -5, -54
"c:\Users\Tsags\OneDrive\Υπολογιστής\techlines\client\src\components\Socket.jsx", "JavaScript JSX", 0, -62, 0, -1, -14, -77
"c:\Users\Tsags\OneDrive\Υπολογιστής\techlines\client\src\components\TextField.jsx", "JavaScript JSX", 0, -14, 0, 0, -2, -16
"c:\Users\Tsags\OneDrive\Υπολογιστής\techlines\client\src\components\UsersTab.jsx", "JavaScript JSX", 0, -156, 0, -1, -6, -163
"c:\Users\Tsags\OneDrive\Υπολογιστής\techlines\client\src\components\useSocket.js", "JavaScript", -17, 0, 0, -1, -5, -23
"c:\Users\Tsags\OneDrive\Υπολογιστής\techlines\client\src\index.css", "CSS", 0, 0, -12, 0, -2, -14
"c:\Users\Tsags\OneDrive\Υπολογιστής\techlines\client\src\index.js", "JavaScript", -14, 0, 0, 0, -3, -17
"c:\Users\Tsags\OneDrive\Υπολογιστής\techlines\client\src\products.js", "JavaScript", -137, 0, 0, 0, -5, -142
"c:\Users\Tsags\OneDrive\Υπολογιστής\techlines\client\src\redux\actions\adminActions.js", "JavaScript", -296, 0, 0, -1, -36, -333
"c:\Users\Tsags\OneDrive\Υπολογιστής\techlines\client\src\redux\actions\cartActions.js", "JavaScript", -167, 0, 0, 0, -13, -180
"c:\Users\Tsags\OneDrive\Υπολογιστής\techlines\client\src\redux\actions\orderActions.js", "JavaScript", -41, 0, 0, 0, -7, -48
"c:\Users\Tsags\OneDrive\Υπολογιστής\techlines\client\src\redux\actions\productActions.js", "JavaScript", -39, 0, 0, 0, -6, -45
"c:\Users\Tsags\OneDrive\Υπολογιστής\techlines\client\src\redux\actions\userActions.js", "JavaScript", -100, 0, 0, 0, -15, -115
"c:\Users\Tsags\OneDrive\Υπολογιστής\techlines\client\src\redux\slices\admin.js", "JavaScript", -141, 0, 0, 0, -8, -149
"c:\Users\Tsags\OneDrive\Υπολογιστής\techlines\client\src\redux\slices\cart.js", "JavaScript", -82, 0, 0, -14, -12, -108
"c:\Users\Tsags\OneDrive\Υπολογιστής\techlines\client\src\redux\slices\order.js", "JavaScript", -44, 0, 0, 0, -6, -50
"c:\Users\Tsags\OneDrive\Υπολογιστής\techlines\client\src\redux\slices\products.js", "JavaScript", -43, 0, 0, 0, -4, -47
"c:\Users\Tsags\OneDrive\Υπολογιστής\techlines\client\src\redux\slices\user.js", "JavaScript", -39, 0, 0, 0, -4, -43
"c:\Users\Tsags\OneDrive\Υπολογιστής\techlines\client\src\redux\store.js", "JavaScript", -16, 0, 0, 0, -3, -19
"c:\Users\Tsags\OneDrive\Υπολογιστής\techlines\client\src\reportWebVitals.js", "JavaScript", -12, 0, 0, 0, -2, -14
"c:\Users\Tsags\OneDrive\Υπολογιστής\techlines\client\src\screens\AdminScreen.jsx", "JavaScript JSX", 0, -53, 0, -1, -8, -62
"c:\Users\Tsags\OneDrive\Υπολογιστής\techlines\client\src\screens\CartScreen.jsx", "JavaScript JSX", 0, -86, 0, 0, -7, -93
"c:\Users\Tsags\OneDrive\Υπολογιστής\techlines\client\src\screens\CheckoutScreen.jsx", "JavaScript JSX", 0, -32, 0, -1, -4, -37
"c:\Users\Tsags\OneDrive\Υπολογιστής\techlines\client\src\screens\LandingScreen.jsx", "JavaScript JSX", 0, -80, 0, 0, -3, -83
"c:\Users\Tsags\OneDrive\Υπολογιστής\techlines\client\src\screens\LoginScreen.jsx", "JavaScript JSX", 0, -102, 0, -2, -9, -113
"c:\Users\Tsags\OneDrive\Υπολογιστής\techlines\client\src\screens\ProductScreen.jsx", "JavaScript JSX", 0, -111, 0, -3, -7, -121
"c:\Users\Tsags\OneDrive\Υπολογιστής\techlines\client\src\screens\ProductsScreen.jsx", "JavaScript JSX", 0, -98, 0, 0, -8, -106
"c:\Users\Tsags\OneDrive\Υπολογιστής\techlines\client\src\screens\RegisterScreen.jsx", "JavaScript JSX", 0, -88, 0, -2, -8, -98
"c:\Users\Tsags\OneDrive\Υπολογιστής\techlines\client\src\screens\RequestsScreen.jsx", "JavaScript JSX", 0, -48, 0, -1, -4, -53
"c:\Users\Tsags\OneDrive\Υπολογιστής\techlines\client\src\screens\ReviewsScreen.jsx", "JavaScript JSX", 0, -163, 0, -7, -15, -185
"c:\Users\Tsags\OneDrive\Υπολογιστής\techlines\client\src\screens\ServicesScreen.jsx", "JavaScript JSX", 0, -62, 0, 0, -5, -67
"c:\Users\Tsags\OneDrive\Υπολογιστής\techlines\client\src\screens\YourOrdersScreen.jsx", "JavaScript JSX", 0, -98, 0, 0, -5, -103
"c:\Users\Tsags\OneDrive\Υπολογιστής\techlines\server\authenticateMiddleware\authMiddleware.js", "JavaScript", 31, 0, 0, 0, 8, 39
"c:\Users\Tsags\OneDrive\Υπολογιστής\techlines\server\database.js", "JavaScript", 15, 0, 0, 1, 8, 24
"c:\Users\Tsags\OneDrive\Υπολογιστής\techlines\server\index.js", "JavaScript", 112, 0, 0, 5, 14, 131
"c:\Users\Tsags\OneDrive\Υπολογιστής\techlines\server\models\Cart.js", "JavaScript", 44, 0, 0, 1, 6, 51
"c:\Users\Tsags\OneDrive\Υπολογιστής\techlines\server\models\Customer.js", "JavaScript", 60, 0, 0, 0, 4, 64
"c:\Users\Tsags\OneDrive\Υπολογιστής\techlines\server\models\Order.js", "JavaScript", 43, 0, 0, 0, 5, 48
"c:\Users\Tsags\OneDrive\Υπολογιστής\techlines\server\models\Product.js", "JavaScript", 57, 0, 0, 0, 4, 61
"c:\Users\Tsags\OneDrive\Υπολογιστής\techlines\server\models\User.js", "JavaScript", 36, 0, 0, 0, 5, 41
"c:\Users\Tsags\OneDrive\Υπολογιστής\techlines\server\models\completedOrder.js", "JavaScript", 43, 0, 0, 0, 3, 46
"c:\Users\Tsags\OneDrive\Υπολογιστής\techlines\server\populationScripts.js", "JavaScript", 97, 0, 0, 9, 14, 120
"c:\Users\Tsags\OneDrive\Υπολογιστής\techlines\server\recommendation.js", "JavaScript", 239, 0, 0, 34, 50, 323
"c:\Users\Tsags\OneDrive\Υπολογιστής\techlines\server\routes\cartRoutes.js", "JavaScript", 95, 0, 0, 6, 26, 127
"c:\Users\Tsags\OneDrive\Υπολογιστής\techlines\server\routes\completedOrderRoutes.js", "JavaScript", 60, 0, 0, 3, 15, 78
"c:\Users\Tsags\OneDrive\Υπολογιστής\techlines\server\routes\customerRoutes.js", "JavaScript", 59, 0, 0, 2, 18, 79
"c:\Users\Tsags\OneDrive\Υπολογιστής\techlines\server\routes\orderRoutes.js", "JavaScript", 56, 0, 0, 2, 11, 69
"c:\Users\Tsags\OneDrive\Υπολογιστής\techlines\server\routes\productRoutes.js", "JavaScript", 92, 0, 0, 2, 15, 109
"c:\Users\Tsags\OneDrive\Υπολογιστής\techlines\server\routes\uploadRoutes.js", "JavaScript", 25, 0, 0, 0, 9, 34
"c:\Users\Tsags\OneDrive\Υπολογιστής\techlines\server\routes\userRoutes.js", "JavaScript", 148, 0, 0, 7, 25, 180
"c:\Users\Tsags\OneDrive\Υπολογιστής\techlines\server\socketMain.js", "JavaScript", 0, 0, 0, 0, 1, 1
"Total", "-", 9, -3313, -12, -23, -166, -3505